01applebees                                             01applebees@gmail.com	        Contributor	0	
abhim                      Abhilasha Bharadwaj Mehta	lookingoodfeelingfab@gmail.com	Contributor	0
Zara Alializara            Zara Ali	                eternity.zarah@gmail.com	Contributor	2
allaboutme                 Christina	                christina.ambrose29@gmail.com	Contributor	5
ananyasarkar              ananya sarkar	                rimpa.diti@gmail.com	        Contributor	0	
Angana                    ChakrabortyAngana               anganac88@gmail.com	        Contributor	1
Ankitaankita1            Ankita	                        ankitadalal@ymail.com	        Contributor	0	
Anushreeanushree         Anushree	                 jindal.anushree@gmail.com	Contributor	1
GetSetBlushapoorvawrites  GetSetBlush	                apoorvawrites@gmail.com	        Contributor	0	
ApsaraApsara-Mishra      Apsara	                          mapsara85@gmail.com	        Contributor	5
asavarisharma            Asavari Sharma	                 swansonsoldier@gmail.com	Contributor	0	
Bhargavi Kadiumbhargavikadium      Bhargavi Kadium	meghana.addepalli@gmail.com	Contributor	1
Nisha singhDalal         Nisha singh	                       nishadalal010@gmail.com	Contributor	1
Debasreemua              Debasree Ghosh	                 debasreeghosh94@gmail.com	Contributor	4
deeviations              Deepthi B	                  deeviations@gmail.com	        Contributor	1
EmbellishedEmbellished   Embellished	                 embellished001@yahoo.com	Contributor	0
HemaHema-Dhawan                                           hemadhawan08@gmail.com	Contributor	0
inderjeetkaur            Inderjeet Kaur	                 inderjeetkaur.0811@gmail.com	Contributor	2
Krittika Biswaskrittika   Krittika Biswas	           biswaskrittika1@gmail.com	Contributor	0
maaya                     maaya	                          vpriya.maaya@gmail.com	Contributor	0	
manu kpmanukp             manu kp	                 manukp@incnut.com	        Contributor	0	
Moumita Ghoshmoumitaghosh   Moumita Ghosh	         ghosh.moumita04@gmail.com	Contributor	2
Nagarathna                 Nagarathna	               nagarathna@stylecraze.com	Contributor	1	
neha7neha7                  Neha                         nehak.das@gmail.com	        Contributor	0
nehaagarwal                Neha Agarwal	              junkkart@gmail.com	        Contributor	0	
Nidhinidhi                 Nidhi                        arora.nidhi.79@gmail.com	Contributor	0	
NiharikaNiharikaPal        Niharika                  niharika@stylecraze.com	        Contributor	0	
Nikita Mankaninikitamankani  Nikita Mankani	       nikitamankani@gmail.com	        Contributor	0
nisha3nisha3                Nisha                         rnishath@yahoo.co.in	        Contributor	3
Marsonmyownistrue           Mars                        onmyownistrue@gmail.com	        Contributor	0	
Poorva Bhatiapoorvabhatia   Poorva Bhatia	        poorvabhatia@gmail.com	        Contributor	0	
Pout Prettypoutpretty       Pout Pretty	                  poutpretty@gmail.com	        Contributor	0	
pratimapratimabhattacharya                            anarkali.boutique1@gmail.com	Contributor	2
prayatibaxi               Prayati Baxi	            makeupandbeautybyprayati@gmail.com	Contributor	0	
preethipreethi            preethi                       cutepinknpurple@gmail.com	Contributor	0
rayconnect                rayConnect                         eerieray@gmail.com	        Contributor	0	
Rids Aroraridsarora1      Rids Arora	              rids29.arora@gmail.com	        Contributor	0
Shahnaz Husainshahnaz-husain   Shahnaz Husain	      itey@shahnaz.in	                Contributor	0	
shailjaShailja                                          shailjakumar03@gmail.com	Contributor	1
SHWETA SRIVASTAVAshwetasrivastava   SHWETA SRIVASTAVA	shweta11sahay@gmail.com	        Contributor	3
Srujanasrujana                                          srujana1616@gmail.com	        Contributor	0	
Swati KalwarSwati-Kalwar      Swati Kalwar               foodfashionfunn@gmail.com	Contributor	0	
Sweet Rosessweetroses         Sweet Roses                  sherin.lloyd@gmail.com	Contributor	0
Vimitha AnandVimitha          Vimitha Anand          	myculinarytrialroom@gmail.com	Contributor	0	
Wanitha Ashokwanitha-ashok    Wanitha Ashok	         wanithaashok@gmail.com	        Contributor	0
zoyazoya                      Zoya	                  zoya_zaman@yahoo.com	        Contributor	1	

     

		

	


